{
  "levels": [
    {
      "id": 1,
      "name": "Grassland",
      "width": 120,
      "height": 34,
      "tileSize": 32,
      "tiles": [
        "........................................................",
        "........................................................",
        "........................................................",
        "........................................................",
        "........................................................",
        "........................................................",
        "........................................................",
        "........................................................",
        "........................................................",
        "........................................................",
        ".................................C......................",
        "..............TTTTTT........TTTTTTTTTTT.................",
        "........................................................",
        "...............................................G........",
        "....................................TTTTTT.............",
        "........................................................",
        "........................................................",
        "........................................................",
        "........................................................",
        "........................................................",
        "........................................................",
        "........................................................",
        "........................................................",
        "........................................................",
        "........................................................",
        "........................................................",
        "........................................................",
        "........................................................",
        "........................................................",
        "........................................................",
        "........................................................",
        "TTTTTTTTTTTTTTTTTTTTTTTTTTTTTTTTTTTTTTTTTTTTTTTTTTTTTT",
        "........................................................"
      ]
    }
  ]
}
